MAPATINICIO
1 1 1 2 1 5 3 1 3 2 3 4 0 0 5 4
0 0 1 3 1 6 0 0 3 3 3 5 5 2 5 5
0 0 1 4 1 7 4 1 4 4 5 1 5 3 5 6
2 1 2 3 0 0 4 2 4 5 6 1 6 2 5 7
2 2 2 4 0 0 4 3 4 6 0 0 6 3 6 4
MAPATFIM
